111111111111111111111111111111
100000010100100000000000100111
100001000010000010010000000011
101000101001000010001000001001
1001010000010C11000010000E0101
100100100000011000100100000001
100000010001000100000000100011
100000000011000000011001001111
100010000000000100000000000111
10010000000000000010000000C001
1P00000000101000001C0000100011
10000000000000100101C000000001
110000000000000001000000000001
1100001000100010100000C00C0101
100100000010000000000010011101
100001000100001100010C11001
110000001100000000001010001001
100010000110000000000000101001
101000011000010011100001000011
11000000C000000101000000C10001
110100000000000101101000001001
100001000000000000001000111001
101000000000000000100010000001
101000000000010000010000000001
110000001000010000000110000001
1000000C0000011010000000000001
100011000000010100000000000011
111000000001000000000010010011
100000000000101000100000000011
111111111111111111111111111111
