111111111111111111111111111111
100000010100100000000000100111
100001000010000010010000000011
101000101001000010001000001001
1001010000010011000010000E0101
100100100000011000100100000001
100000010001000100000000100011
100000000011000000011001001111
100010000000000100000000000111
100100000000000000100000000001
1P0000000010100000100000100011
100000000000001001010000000001
110000000000000001000000000001
110000100010001010000000000101
100100000010000000000010011101
110000001100000000001010001001
100010000110000000000000101001
101000011000010011100001000011
110000000000000101000000010001
110100000000000101101000001001
100001000000000000001000111001
101000000000000000100010000001
101000000000010000010000000001
110000001000010000000110000001
100000000000011010000000000001
100011000000010100000000000011
111000000001000000000010010011
100000000000101000100000000011
111111111111111111111111111111
