1111111111
1000000001
1001011001
11000C0P01
1010001101
1C00100001
1001001001
1110011001
1C000010E1
1111111111
