11111111111111111111
10000100000001010001
11000000010000010101
10010000011000100001
10010010001001001001
10000000000111100001
1C010000000000100001
10010000110110010001
1001P000010001100001
100011100C0001010001
101C1000010000001001
10100100001100000011
10000010000000100001
10000000X00101000001
10001000000C00000011
11010000000001000111
1000001C010001010101
1000X0100100011100E1
11001010000000100101
11111111111111111111
