111111111111111
100001C0000C0C1
110010000101001
111000100101001
100000000000001
100001000000001
111100010000001
100011000010001
101001110000101
100P00100010001
1000E00C0000101
10C010011000001
100011001001101
100000000000001
111111111111111
