1111111111
1000110001
100P000001
1010000011
1000001001
1010101C01
1000000001
1000000001
10000000E1
1111111111
