1111111111
1001110001
111P100001
101C000011
1000001111
1010101C01
10000E01C1
1000000001
1000000001
1111111111
