1111111111
1001110001
1110100001
101C000011
1000001111
1X10101001
1000010101
1000000111
10000PEXC1
1111111111
